88,,,,888,,,,88
8,,,,,,,,,,,,,8
,,,O,,,,,,,O,,,
,,,,,,,,,,,,,,,
8,,,,,,,,,,,,,8
8,,,,,,#,,,,,,8
8,,,,,,#,,,,,,8
8,,,,,,,,,,,,,8
,,,,,,,,,,,,,,,
,,,O,,,,,,,O,,,
8,,,,,,,,,,,,,8
88,,,,888,,,,88
