8888888888888888
8,,,,,,,,,,,,,,8
8,,OO,,,,,,OO,,8
8,,OO,,,,,,OO,,8
8,,,,,,,,,,,,,,8
8,,,,,,##,,,,,,8
8,,,,,,##,,,,,,8
8,,,,,,,,,,,,,,8
8,,OO,,,,,,OO,,8
8,,OO,,,,,,OO,,8
8,,,,,,,,,,,,,,8
8888888888888888
